1111111111111
100100C000IC1
1C00011111001
1P0011E000001
1111111111111